assert.h	assert() 매크로를 정의하여 사용자가 프로그램 진단 기능을 추가하여 논리적 오류를 찾을 수 있게 한다. 
complex.h	복소수를 위한 자료형 및 연산 함수를 포함하고 있다. 
ctype.h	대상 문자 셋에서 문자를 구분하기 위한 함수들을 선언한다
errno.h	전역 변수 errno와 오류 상태를 나타내기 위한 상수가 정의되어 있다
fenv.h	부동 소수 연산 환경을 확인하거나 변경하기 위한 자료형, 상수, 그리고 함수들을 정의한다
float.h	부동 소수 자료형을 설정하기 위한 상수와 매크로를 정의한다
inttype.h	헤더파일 <inttypes.h>은 <stdint.h>을 포함하며 다음의 정수 자료형을 처리하기위한 자료형, 매크로, 그리고 함수를 정의한다.
iso646.h	대체 문자열 <iso646.h> 헤더는 토큰들에 대응하는 11개의 매크로를 정의한다.
limits.h	헤더파일 <limits.h>는 정수형 타입의 크기를 정의한다.
locale.h	헤더 파일 <locale.h>은 구조체 lconv를 정의한다.
math.h	헤더파일 <math.h>는 수학 함수 지원을 위한 지원하는 함수, 부동 소수점 수를 표현하기 위한 자료형, 수학 상수를 정의한다. 
setjmp.h	헤더파일 <setjump.h>은 jmp_buf와 sigjmp_buf 타입의 배열을 정의한다.
signal.h	헤더 파일 <signal.h>은 시그널을 처리하기 위한 상수와 함수를 정의한다.
stdarg.h	헤더 파일 <stdarg.h>은 가변 길이 인자를 처리하는 매크로를 정의한다.
stdbool.h	Boolean tests 작성에 적합한 type 및 여러 매크로를 정의한다.
stddef.h	프로그램 전체에서 일반적으로 사용되는 여러 유형과 매크로를 정의한다.
stdint.h	다양한 integer types, 관련된 매크로 그리고 사이즈 제약을 정의한다.
stdio.h	헤더 파일 <stdio.h>은 표준 입출력과 관련된 자료형, 매크로, 입력과 출력을 관련 기능을 수행하는 함수들을 정의한다.
stdlib.h	stdlib.h는 C 언어의 표준 라이브러리로, 문자열 변환, 의사 난수 생성, 동적 메모리 관리 등의 함수들을 포함하고 있다.
string.h	<string.h> 헤더 파일은 메모리 블록이나 문자열을 다룰 수 있는 함수들을 포함한다.
time.h	헤더 파일 <time.h> 시간과 관련된 자료형, 상수, 그리고 함수들을 정의한다.
tgmath.h	헤더 파일 <tgmath.h>는 <math.h>와 <complex.h> 를 포함하며, float 형이나 long double형을 제외한 함수만이 들어있다. 
wchar.h	헤더 파일 <wchar.h>은 확장 문자 처리를 위한 자료형, 상수, 그리고 함수들을 정의한다.
wctype.h	헤더 파일 <wctype.h>은 로케일에 따른 확장 문자의 타입을 확인하기 위한 자료형, 상수, 그리고 함수들을 정의한다.